2차전지_부품|KG케미칼|PI첨단소재|POSCO|SKC|SK아이이테크놀로지|TCC스틸|금양|나노신소재|나라엠앤디|대주전자재료|대한유화|동국알앤에스|동원시스템즈|동화기업|삼아알미늄|삼진엘앤디|상신이디피|상아프론테크|서원인텍|솔루스첨단소재|솔브레인|스카이이앤엠|신성델타테크|신흥에스이씨|쎄노텍|아이티엠반도체|알루코|애경유화|에이에프더블류|에코프로|에코프로비엠|엘앤에프|엠케이전자|영화테크|유에스티|이랜텍|이아이디|이엔드디|일진머티리얼즈|천보|켐트로스|코스모신소재|코스모화학|테이팩스|파워로직스|포스코케미칼|한농화성|한송네오텍|황금에스티|후성|
2차전지_생산|LG화학|SK이노베이션|삼성SDI|
임플란트|디오|오스템임플란트|레이|덴티움|
아이폰|LG이노텍|아이티엠반도체|이녹스첨단소재|비에이치|
보톡스|휴젤|파마리서치|메디톡스|제테마|
반도체부품|에스에이엠티|에스앤에스텍|동진쎄미켐|하나머티리얼즈|덕산테코피아|이엔에프테크놀로지|이녹스첨단소재|솔브레인|네패스|덕산하이메탈|해성디에스|원익머트리얼즈|에프엔에스테크|미코|KEC|ISC|동운아나텍|월덱스|
반도체장비|GST|HB테크놀러지|SFA반도체|WI|고영|기가레인|네온테크|디아이|로보스타|로체시스템즈|리노공업|미래산업|서플러스글로벌|성도이엔지|신성이엔지|싸이맥스|쎄미시스코|에스에프에이|에스티아이|에이팩트|에프에스티|엑시콘|엘오티베큠|예스티|오션브릿지|원익IPS|유니셈|유니테스트|유진테크|이오테크닉스|인텍플러스|제너셈|제이스텍|제이티|주성엔지니어링|코디|코디엠|코미코|코세스|탑엔지니어링|테스|테크윙|티씨케이|티에스이|프로텍|피에스케이홀딩스|하나마이크론|한미반도체|한양이엔지|한화에어로스페이스|
시스템반도체|테크윙|한미반도체|LX세미콘|디아이|테스나|에이디테크놀로지|피에스케이|네패스|SFA반도체|DB하이텍|어보브반도체|하나마이크론|윈팩|아이에이|에스앤에스텍|엘비세미콘|네패스아크|
디스플레이|주성엔지니어링|SK머티리얼즈|인터플렉스|AP시스템|에스에프에이|PI첨단소재|덕산네오룩스|HB테크놀러지|
전자결제|인포바인|카페24|KG모빌리언스|코리아센터|SBI핀테크솔루션즈|한국정보통신|NHN한국사이버결제|NHN|인포뱅크|세틀뱅크|갤럭시아머니트리|KG이니시스|쿠콘|다날|
석유화학|SKC|효성화학|롯데케미칼|금호석유|애경유화|
인터넷|NAVER|카카오|
영상콘텐츠|삼화네트웍스|위지윅스튜디오|에이스토리|초록뱀미디어|
코로나치료|동아에스티|삼성바이오로직스|녹십자랩셀|녹십자셀|박셀바이오|셀트리온헬스케어|셀트리온|셀트리온제약|네이처셀|압타바이오|국전약품|한국비엔씨|엑세스바이오|
코로나치료제|JW중외제약|SK바이오사이언스|강스템바이오텍|골드퍼시픽|국전약품|네이처셀|녹십자|대웅|대웅제약|레고켐바이오|메디콕스|바이오리더스|부광약품|삼천당제약|셀리드|셀리버리|셀트리온|신풍제약|쎌마테라퓨틱스|아이진|압타머사이언스|압타바이오|앱클론|옵티팜|유나이티드제약|유바이오로직스|유틸렉스|일양약품|제넥신|진매트릭스|진원생명과학|카이노스메드|코미팜|크리스탈지노믹스|한국비엔씨|한국파마|현대바이오|
코로나19종합|EDGC|JW중외제약|SK바이오사이언스|SV인베스트먼트|강스템바이오텍|녹십자|녹십자엠에스|뉴지랩파마|대웅|대웅제약|디엔에이링크|랩지노믹스|레고켐바이오|마크로젠|미코|바디텍메드|바이오니아|바이오톡스텍|부광약품|비씨월드제약|셀리버리|셀트리온|수젠텍|신풍제약|씨젠|앤디포스|앱클론|얼라인드|엑세스바이오|엔지켐생명과학|오상자이엘|옵티팜|유나이티드제약|유바이오로직스|유틸렉스|인트론바이오|일양약품|제넥신|제일약품|지노믹트리|진매트릭스|진원생명과학|카이노스메드|코미팜|파미셀|팜젠사이언스|피씨엘|피에이치씨|휴마시스|휴온스|
제약업체|CMG제약|JW신약|JW중외제약|SK바이오사이언스|SK바이오팜|경남제약|경동제약|경보제약|고려제약|광동제약|국제약품|녹십자|대웅제약|대원제약|대한뉴팜|대한약품|대화제약|동국제약|동아쏘시오홀딩스|동화약품|명문제약|보령제약|부광약품|비씨월드제약|삼성바이오로직스|삼성제약|삼아제약|삼진제약|삼천당제약|서울제약|셀트리온제약|신일제약|신풍제약|에스티팜|에이치엘비제약|영진약품|유나이티드제약|유한양행|이연제약|일동제약|일성신약|일양약품|종근당|코오롱생명과학|테라젠이텍스|하이텍팜|한독|한미약품|현대약품|환인제약|
게임|카카오게임즈|엔씨소프트|펄어비스|넷마블|
자동차|기아|만도|현대차|현대모비스|
수소차|EG|SNT모티브|STX중공업|국일제지|글로벌에스엠|기아|뉴인텍|대우부품|대원강업|동아화성|동양피스톤|두산퓨얼셀|디아이티|디와이|디케이락|모토닉|삼기|삼보모터스|삼화전자|성문전자|성창오토텍|세원|세종공업|시노펙스|아이에이|에스에너지|에스퓨얼셀|에코바이오|엔케이|영화테크|우리산업|우수AMS|원익머트리얼즈|유니크|이엠코리아|인지컨트롤스|일지테크|일진다이아|제이엔케이히터|지엠비코리아|코오롱인더|코웰패션|평화산업|평화홀딩스|풍국주정|한온시스템|현대모비스|현대차|효성중공업|효성첨단소재|
자동차부품|KB오토시스|LX하우시스|SNT모티브|경창산업|대성엘텍|대우부품|대원강업|대원산업|대유에이텍|대유플러스|덕양산업|동원금속|디와이|모베이스전자|모토닉|부산주공|삼성공조|상신브레이크|성우하이텍|세종공업|센트랄모텍|에스엘|에코플라스틱|엠에스오토텍|영화금속|오스템|유니온머티리얼|유니크|유라테크|유성기업|인지컨트롤스|인팩|일지테크|재영솔루텍|체시스|케이비아이동국실업|코프라|클라우드에어|티에이치엔|티피씨글로벌|포메탈|피에스텍|피에이치에이|한국단자|한국프랜지|한온시스템|한일단조|현대모비스|현대위아|화신|
폭염|신일전자|에쎈테크|파세코|오텍|위닉스|코웨이|계양전기|
메타버스|CJ ENM|iMBC|KT|LG유플러스|NAVER|SBS|SK텔레콤|넵튠|다보링크|대성창투|덱스터|맥스트|바이브컴퍼니|비비안|선익시스템|씨엠에스에듀|씨이랩|아진엑스텍|알체라|에스코넥|에이트원|엔피|엠게임|옵티시스|와이제이엠게임즈|위지윅스튜디오|이노뎁|이랜텍|자이언트스텝|주연테크|지니뮤직|칩스앤미디어|카카오|코세스|펄어비스|한빛소프트|현대차|
원전|우진|한전기술|한전KPS|두산중공업|한신기계|
풍력|씨에스윈드|동국S&C|씨에스베어링|삼강엠앤티|국도화학|
패션/의류|BYC|F&F|LF|LS네트웍스|SG세계물산|TBH글로벌|국동|그리티|까스텔바작|대현|더네이쳐홀딩스|리노스|메타랩스|배럴|비비안|삼성물산|신성통상|신세계인터내셔날|신영와코루|신원|쌍방울|에스제이그룹|에스티오|영원무역|원풍물산|윌비스|이스트아시아홀딩스|인디에프|인바이오젠|제이에스코퍼레이션|제이에스티나|젬백스링크|지엔코|진도|코데즈컴바인|코오롱인더|코웰패션|크리스에프앤씨|태평양물산|토박스코리아|패션플랫폼|한섬|한세실업|한세엠케이|형지I&C|형지엘리트|호전실업|화승엔터프라이즈|화승인더|휠라홀딩스|
건설|GS건설|삼성물산|HDC현대산업|현대건설|대우건설|
3D낸드|한솔케미칼|디엔에프|케이씨텍|유진테크|원익IPS|테스|테크윙|피에스케이|심텍|유니테스트|원익QnC|
조선|현대미포조선|한국조선해양|삼성중공업|대우조선해양|한진중공업|
전력설비|현대일렉트릭|LS|LS ELECTRIC|인스코비|
면역항암제|메드팩토|오스코텍|차바이오텍|헬릭스미스|한올바이오파마|제넥신|파멥신|셀리드|
YG|와이지엔터테인먼트|YG PLUS|
기계|SIMPAC|삼익THK|와이지-원|두산인프라코어|현대건설기계|두산밥캣|진성티이씨|디와이파워|
스마트카|오비고|한컴MDS|모트렉스|인포뱅크|
스마트폰|KH바텍|LG디스플레이|LG이노텍|기가레인|나무가|덕산네오룩스|동운아나텍|디스플레이텍|디지탈옵틱|멜파스|모다이노칩|모베이스|블루콤|삼성SDI|삼성전자|서진시스템|성우전자|솔루에타|슈피겐코리아|시노펙스|아모텍|아이앤씨|아진엑스텍|알에프세미|알에프텍|에스맥|에이스테크|엘디티|엘엠에스|와이제이엠게임즈|유아이디|이미지스|이수페타시스|이엠텍|인탑스|인터플렉스|자화전자|장원테크|지나인제약|캠시스|켐트로닉스|크루셜텍|텔레칩스|토비스|파워로직스|파트론|피델릭스|하이비젼시스템|한국컴퓨터|해성옵틱스|
무선충전|LG이노텍|LG전자|LS|삼성전기|삼성전자|아모센스|알에프텍|이랜텍|켐트로닉스|포스코 ICT|한솔테크닉스|
손해보험|DB손해보험|롯데손해보험|메리츠화재|삼성화재|코리안리|한화손해보험|현대해상|흥국화재|
레져|호텔신라|파라다이스|강원랜드|
여행|SM C&C|노랑풍선|레드캡투어|롯데관광개발|모두투어|세중|인터파크|참좋은여행|하나투어|
은행|우리금융지주|하나금융지주|BNK금융지주|신한지주|KB금융|DGB금융지주|JB금융지주|기업은행|제주은행|한국금융지주|
증권|유안타증권|NH투자증권|이베스트투자증권|미래에셋증권|삼성증권|키움증권|한화투자증권|
화장품|CSA 코스믹|LG생활건강|YG PLUS|강스템바이오텍|국제약품|글로본|네이처셀|넥스트아이|대봉엘에스|동성제약|리더스코스메틱|미원상사|바이온|세원이앤씨|세화피앤씨|승일|씨큐브|씨티케이|아모레퍼시픽|아우딘퓨쳐스|애경산업|애니젠|에스디생명공학|에이블씨엔씨|에프앤리퍼블릭|연우|오가닉티코스메틱|잇츠한불|잉글우드랩|자안코스메틱|제닉|제이시스메디칼|제이준코스메틱|컬러레이|케어젠|코디|코리아나|코스맥스|코스메카코리아|코웨이|콜마비앤에이치|클래시스|클리오|토니모리|프로스테믹스|한국주철관|한국콜마|한국콜마홀딩스|한국화장품|한국화장품제조|현대바이오랜드|
철강|KG동부제철|POSCO|고려제강|대한제강|동국제강|세아베스틸|세아제강|포스코강판|한국철강|현대제철|
줄기세포|안트로젠|차바이오텍|테고사이언스|마크로젠|녹십자랩셀|메디포스트|
희토류|유니온|동국알앤에스|유니온머티리얼|티플랙스|POSCO|
가상화폐|비덴트|다날|위지트|우리기술투자|에이티넘인베스트|엠게임|클라우드에어|퓨쳐스트림네트웍스|TS인베스트먼트|갤럭시아머니트리|SBI인베스트먼트|
일자리|대성창투|아이비김영|윌비스|메가엠디|TS인베스트먼트|DSC인베스트먼트|사람인에이치알|
탄소배출|에코프로에이치엔|에코바이오|에코프로|한솔홈데코|클라우드에어|
제약|대웅제약|신일제약|하이텍팜|서울제약|JW중외제약|JW신약|경동제약|삼천당제약|동화약품|일양약품|테라젠이텍스|부광약품|비씨월드제약|SK바이오사이언스|유나이티드제약|동아쏘시오홀딩스|종근당|삼진제약|동국제약|SK바이오팜|현대약품|영진약품|유한양행|CMG제약|녹십자|삼성바이오로직스|한미약품|신풍제약|셀트리온제약|이연제약|
철도|현대로템|대아티아이|동아지질|제룡전기|현대제철|대호에이엘|특수건설|남광토건|세명전기|서한|삼현철강|선도전기|국영지앤엠|비츠로테크|케이씨에스|동일제강|
IT대형|삼성전자|SK하이닉스|삼성에스디에스|LG디스플레이|삼성SDI|LG전자|
SM엔터|에스엠|SM C&C|SM Life Design|키이스트|
유통|BGF리테일|CJ ENM|GS리테일|광주신세계|다나와|롯데쇼핑|롯데하이마트|베뉴지|세이브존I&C|신세계|엔에스쇼핑|이마트|현대백화점|현대홈쇼핑|호텔신라|
항공|AK홀딩스|대한항공|아시아나항공|에어부산|제주항공|진에어|티웨이항공|티웨이홀딩스|한진칼|
방산|DMS|LIG넥스원|SNT모티브|SNT중공업|STX엔진|대우조선해양|비츠로테크|빅텍|삼영이엔씨|스페코|쌍용정보통신|아이쓰리시스템|에이스테크|에이트원|우리기술|웨이브일렉트로|이엠코리아|켄코아에어로스페이스|퍼스텍|평화산업|포메탈|풍산|풍산홀딩스|한국조선해양|한국항공우주|한일단조|한진중공업|한화|한화시스템|한화에어로스페이스|현대로템|현대위아|혜인|휴니드|
엔터|CJ ENM|IHQ|JYP Ent.|NEW|SM C&C|TJ미디어|갤럭시아에스엠|버킷스튜디오|삼화네트웍스|스튜디오드래곤|에스엠|에프엔씨엔터|와이지엔터테인먼트|제이콘텐트리|지니뮤직|초록뱀미디어|카카오|큐로홀딩스|큐브엔터|키이스트|판타지오|팬엔터테인먼트|하이브|
해운|HMM|KSS해운|대한해운|팬오션|
3D프린터|TPC|로보스타|모아텍|세중|신도리코|에스티아이|코렌텍|티앤알바이오팹|프로텍|하이비젼시스템|한국테크놀로지|휴림로봇|
모바일콘텐츠|KG모빌리언스|KT|NAVER|NHN벅스|SK텔레콤|TJ미디어|YBM넷|YTN|게임빌|네오위즈홀딩스|다날|디앤씨미디어|미스터블루|민앤지|바른손|삼성출판사|셀바스AI|인포뱅크|자이언트스텝|지니뮤직|카카오|컴투스|케이티알파|키다리스튜디오|티사이언티픽|포시에스|폴라리스오피스|플랜티넷|한글과컴퓨터|한컴위드|
LED|KH 필룩스|LG전자|광전자|금호에이치티|금호전기|나노신소재|드림텍|레이크머티리얼즈|루멘스|비보존 헬스케어|빛샘전자|삼성전자|삼진엘앤디|서울바이오시스|서울반도체|성호전자|소룩스|아이엘사이언스|알에프세미|알에프텍|에스엘바이오닉스|에스폴리텍|에프알텍|엘디티|엘컴텍|연이비앤티|오디텍|우리바이오|우리이앤엘|우리조명|일진디스플|제이엠아이|케이엔제이|케이엠더블유|클라우드에어|태경비케이|태경산업|파인테크닉스|파커스|포인트엔지니어링|한국단자|한라IMS|한솔테크닉스|
21신규주|HK이노엔|SK바이오사이언스|SK아이이테크놀로지|나노씨엠에스|네오이뮨텍(Reg.S)|라이프시맨틱스|레인보우로보틱스|모비릭스|바이오다인|뷰노|브레인즈컴퍼니|삼영에스앤씨|샘씨엔에스|선진뷰티사이언스|솔루엠|신한제7호스팩|싸이버원|씨앤씨인터내셔널|씨앤투스성진|씨이랩|아이퀘스트|에이디엠코리아|에이치피오|엔비티|엔시스|엔에이치스팩19호|엘비루셈|오로스테크놀로지|와이더플래닛|유일에너테크|원티드랩|이노뎁|이삭엔지니어링|자이언트스텝|제노코|제주맥주|진시스템|쿠콘|프레스티지바이오로직스|프레스티지바이오파마|플래티어|피엔에이치테크|핑거|해성티피씨|큐라클|맥스트|오비고|에스디바이오|큐라클|쿠콘|
바이오시밀러|LG화학|녹십자|대웅제약|동아에스티|바이넥스|삼성바이오로직스|셀트리온|셀트리온제약|셀트리온헬스케어|알테오젠|에이프로젠제약|이수앱지스|종근당|파멥신|팬젠|프레스티지바이오로직스|프레스티지바이오파마|한미약품|한올바이오파마|
남북경협|KH E&T|경농|남광토건|남해화학|남화토건|녹십자|다스코|도화엔지니어링|롯데정밀화학|삼부토건|스페코|신원|아난티|양지사|인디에프|인지컨트롤스|일신석재|자화전자|재영솔루텍|제이에스티나|조비|지엔씨에너지|한국석유|한국전력|한창|현대건설|현대엘리베이|희림|
철도|HDC아이콘트롤스|국영지앤엠|남광토건|다원시스|대아티아이|대양전기공업|대원전선|대호에이엘|도화엔지니어링|동아지질|동일제강|리노스|메디콕스|부산산업|비츠로테크|빛샘전자|삼일씨엔에스|삼현철강|서암기계공업|서한|선도전기|세명전기|알루코|에스트래픽|에스피지|옵티시스|와이어블|우리기술|우리넷|우림기계|우원개발|유신|이엠코리아|제룡전기|케이씨에스|특수건설|푸른기술|피앤씨테크|하이록코리아|한국종합기술|현대로템|현대제철|황금에스티|
건설중소형|DL건설|KCC건설|SGC이테크건설|계룡건설|금호건설|까뮤이앤씨|남광토건|남화토건|대원|동부건설|동신건설|동원개발|범양건영|삼부토건|삼일기업공사|삼호개발|상지카일룸|서한|서희건설|신세계건설|신원종합개발|아이에스동서|우원개발|이화공영|일성건설|진흥기업|코오롱글로벌|태영건설|한라|한신공영|화성산업|
음식료|CJ제일제당|CJ프레시웨이|LG생활건강|SPC삼립|국순당|남양유업|네이처셀|노바렉스|농심|대상|대한제당|대한제분|동서|동원F&B|디딤|롯데제과|롯데칠성|롯데푸드|맘스터치|매일유업|미래생명자원|보라티알|빙그레|사조동아원|삼양사|삼양식품|샘표식품|서울식품|신세계푸드|신송홀딩스|에이치엘사이언스|엠에스씨|엠피대산|오뚜기|오리온|인산가|정다운|조흥|코스맥스엔비티|크라운제과|푸드나무|푸드웰|풀무원|하이트진로|하이트진로홀딩스|한국맥널티|한탑|해태제과식품|현대그린푸드|흥국에프엔비|
시멘트|SG|고려시멘트|동양|모헨즈|보광산업|부산산업|삼표시멘트|서산|성신양회|쌍용C&E|쎄니트|아세아시멘트|유니온|유진기업|한일시멘트|한일현대시멘트|홈센타홀딩스|
농업|KG케미칼|KPX생명과학|TYM|경농|골든센츄리|남해화학|농우바이오|대동|대동금속|대동기어|대유|동방아그로|롯데정밀화학|성보화학|아세아텍|아시아종묘|우진비앤지|인바이오|조비|카프로|포메탈|효성오앤비|
mRNA|나이벡|녹십자|삼양홀딩스|서린바이오|셀루메드|아미노로직스|아이진|에스티팜|엔지켐생명과학|올리패스|올릭스|이연제약|진원생명과학|파미셀|한미사이언스|한미약품|
진단키트|EDGC|나노엔텍|녹십자엠에스|대웅제약|드림텍|디엔에이링크|랩지노믹스|마이크로디지탈|메디콕스|미코|미코바이오메드|바디텍메드|바이오니아|바이오스마트|바이오톡스텍|소마젠|수젠텍|시스웍|씨젠|씨티씨바이오|앤디포스|얼라인드|에스디바이오센서|엑세스바이오|오상자이엘|우리들휴브레인|인바이오젠|인트론바이오|제노포커스|제놀루션|젠큐릭스|지노믹트리|진매트릭스|진시스템|천랩|퀀타매트릭스|파미셀|팜젠사이언스|피씨엘|피에이치씨|휴마시스|휴온스|
2차전지|KG케미칼|LG화학|POSCO|SKC|SK아이이테크놀로지|SK이노베이션|넥스트아이|대보마그네틱|대주전자재료|디아이티|디에이테크놀로지|브이원텍|삼성SDI|삼진엘앤디|상신이디피|상아프론테크|서원인텍|세방전지|솔루스첨단소재|스카이이앤엠|신흥에스이씨|쎄노텍|씨아이에스|애경유화|에이에프더블류|에코프로|에코프로비엠|엔에스|엘앤에프|엠케이전자|엠플러스|영화테크|원익피앤이|웰크론한텍|유에스티|이노메트리|이랜텍|일진머티리얼즈|천보|켐트로스|코스모신소재|코스모화학|코윈테크|테이팩스|파워로직스|포스코케미칼|피엔티|필옵틱스|황금에스티|후성|
게임|KH 일렉트론|NAVER|NHN|SNK|네오리진|네오위즈|네오위즈홀딩스|넥슨지티|넵튠|넷마블|다날|대원미디어|더블유게임즈|드래곤플라이|룽투코리아|모비릭스|미투온|바른손이앤에이|베노홀딩스|선데이토즈|손오공|액토즈소프트|엔씨소프트|엠게임|웹젠|위메이드|위메이드맥스|이스트소프트|조이시티|카카오게임즈|컴투스|펄어비스|플레이위드|한빛소프트|
카뱅|KB금융|넷마블|드림시큐리티|알서포트|엑셈|예스24|이니텍|인포뱅크|카카오|카카오뱅크|한국금융지주|한세예스24홀딩스|
휴대폰부품|KH바텍|LG이노텍|기가레인|나노스|나무가|디스플레이텍|디에이피|레몬|모다이노칩|모베이스|바이오로그디바이스|상신이디피|서울반도체|서원인텍|서진시스템|세경하이테크|세코닉스|아모텍|아비코전자|아이앤씨|알에프세미|알에프텍|앤디포스|에스코넥|엑사이엔씨|엘컴텍|엠씨넥스|옵트론텍|와이솔|와이팜|우주일렉트로|유아이엘|이라이콤|이랜텍|이엠텍|인탑스|인터플렉스|재영솔루텍|제이앤티씨|제주반도체|지나인제약|캠시스|코아시아옵틱스|텔레칩스|파워로직스|파인테크닉스|피델릭스|한국컴퓨터|한솔테크닉스|
갤럭시부품|KH바텍|PI첨단소재|기가레인|나무가|뉴프렉스|대덕전자|덕산네오룩스|드림텍|레몬|모베이스|비에이치|삼성전기|삼성전자|세경하이테크|세코닉스|시노펙스|신화콘텍|아모그린텍|아모텍|아이엠|알에프텍|앤디포스|엠씨넥스|옵트론텍|와이팜|이녹스첨단소재|이랜텍|이수페타시스|인탑스|인터플렉스|자화전자|제이앤티씨|캠시스|켐트로닉스|코리아써키트|파워로직스|파트론|한솔테크닉스|
태양광|KCC|KC그린홀딩스|KC코트렐|LG전자|LS ELECTRIC|OCI|SDN|SKC|SK디앤디|SK머티리얼즈|광명전기|나노신소재|뉴인텍|다스코|다원시스|대성파인텍|대주전자재료|대한그린파워|도화엔지니어링|레이크머티리얼즈|매커스|신성이엔지|아바코|알에스오토메이션|에스에너지|에스에프에이|에스와이|에스폴리텍|엘오티베큠|원익IPS|윌링스|유니테스트|이건홀딩스|제우스|주성엔지니어링|코미코|코오롱글로벌|티씨케이|파루|한국전력|한미반도체|한솔테크닉스|한화|한화솔루션|현대에너지솔루션|혜인|
유전자치료제|EDGC|고바이오랩|녹십자|디엔에이링크|랩지노믹스|마크로젠|바이오니아|셀레믹스|소마젠|신테카바이오|씨젠|아미코젠|에스디바이오센서|엑세스바이오|엔젠바이오|올리패스|우정바이오|제넥신|제노포커스|제놀루션|젠큐릭스|지노믹트리|지놈앤컴퍼니|진시스템|진원생명과학|천랩|코오롱생명과학|클리노믹스|테라젠이텍스|티움바이오|파나진|헬릭스미스|
해저터널|KT서브마린|LS|동아지질|부산산업|세명전기|우원개발|특수건설|한국선재|
인터넷은행|GS리테일|KB금융|KG모빌리언스|KG이니시스|KT|NH투자증권|NICE평가정보|넷마블|다날|드림시큐리티|라온시큐어|모바일리더|미래테크놀로지|민앤지|브리지텍|시큐브|알서포트|엑셈|예스24|이글루시큐리티|이니텍|인포바인|인포뱅크|카카오|카카오뱅크|코나아이|포스코 ICT|한국금융지주|한국전자인증|한국정보인증|한세예스24홀딩스|한컴위드|한화생명|현대이지웰|
IoT|HDC아이콘트롤스|LG유플러스|SGA|SGA솔루션즈|가온미디어|기가레인|누리플렉스|다산네트웍스|대한과학|드림어스컴퍼니|링네트|삼성에스디에스|삼진|아이엠|알파홀딩스|에스넷|에이디칩스|에이디테크놀로지|에이텍|엑사이엔씨|엔텔스|오픈베이스|위즈코프|유비쿼스|유진로봇|이그잭스|이아이디|케이사인|케이엘넷|코맥스|코콤|테스나|텔레필드|한국전자인증|효성ITX|
영화|CJ CGV|CJ ENM|IHQ|NEW|SM Life Design|덱스터|롯데쇼핑|바른손|바른손이앤에이|버킷스튜디오|쇼박스|쎄니트|아센디오|제이콘텐트리|
스마트그리드|CS|LS ELECTRIC|광명전기|누리플렉스|비츠로셀|삼화콘덴서|서전기전|스맥|아모그린텍|아이앤씨|옴니시스템|이글루시큐리티|인스코비|일진전기|일진홀딩스|코콤|포스코 ICT|피앤씨테크|피에스텍|한전산업|
비철금속|고려아연|국일신동|그린플러스|남선알미늄|대양금속|대유플러스|대창|대호에이엘|삼아알미늄|서원|쎄니트|알루코|영풍|이구산업|조일알미늄|태경산업|티플랙스|포스코엠텍|풍산|풍산홀딩스|현대비앤지스틸|황금에스티|
온실가스|KC코트렐|SGC에너지|그린케미칼|세종공업|에코바이오|에코프로|에코프로에이치엔|유니드|이건산업|켐트로스|클라우드에어|한솔홈데코|후성|휴켐스|
의료기기|나노엔텍|대원제약|덴티움|디알텍|디오|랩지노믹스|레고켐바이오|레이언스|루트로닉|메디아나|메타바이오메드|멕아이씨에스|미래컴퍼니|바디텍메드|바텍|뷰웍스|삼성전자|세운메디칼|세종메디칼|셀바스헬스케어|솔고바이오|시너지이노베이션|신흥|씨유메디칼|아스타|아이센스|아이쓰리시스템|엘앤케이바이오|오스테오닉|오스템임플란트|우리들휴브레인|원익|유비케어|유앤아이|인바디|인터로조|인트로메딕|제노레이|지티지웰니스|코렌텍|큐렉소|클래시스|파마리서치|피씨엘|피제이전자|하이로닉|한독|한스바이오메드|휴마시스|휴비츠|
치매|SK케미칼|고려제약|국전약품|네이처셀|대웅제약|대화제약|동구바이오제약|동아에스티|리메드|메디포스트|메디프론|명문제약|모나리자|바이오스마트|배럴|보령제약|삼진제약|수젠텍|신신제약|씨티씨바이오|아이큐어|에이비엘바이오|에이치엘비제약|에이프로젠제약|엔에스엔|유유제약|유한양행|이연제약|일동제약|일진홀딩스|젬백스|종근당|진양제약|켐온|펩트론|퓨쳐켐|피씨엘|피플바이오|한국파마|현대약품|화일약품|환인제약|
전력저장장치|LG전자|LG화학|LS ELECTRIC|SK디앤디|SK이노베이션|비나텍|비츠로셀|삼성SDI|삼진엘앤디|삼화전기|삼화콘덴서|상아프론테크|서진시스템|세방전지|신성이엔지|씨아이에스|알에스오토메이션|에이치엘비파워|엠플러스|원익피앤이|윌링스|유일에너테크|젬백스지오|파워로직스|포스코 ICT|피엔티|현대에너지솔루션|효성중공업|
리모델링|오하임아이엔티|KCC|KCC글라스|LX하우시스|SUN&L|국보디자인|대림B&Co|동화기업|라이온켐텍|벽산|삼목에스폼|시공테크|에넥스|오하임아이엔티|이건산업|이건홀딩스|진양화학|파세코|하츠|한샘|한솔홈데코|현대리바트|희림|
원격진료|JW중외제약|나노엔텍|네오펙트|녹십자홀딩스|라이프시맨틱스|마크로젠|메디포스트|뷰웍스|비트컴퓨터|소프트센|아스타|오스템임플란트|유비케어|이지케어텍|인바디|인성정보|인피니트헬스케어|제이엘케이|차바이오텍|케어랩스|테라젠이텍스|파마리서치|휴비츠|
공작기계|SIMPAC|SNT중공업|넥스턴바이오|삼익THK|서암기계공업|스맥|에이비프로바이오|와이지-원|유니온머티리얼|이엠코리아|한국주강|현대위아|화천기계|화천기공|
SI|DB|SGA|SGA솔루션즈|SK|나무기술|다우기술|대신정보통신|데이타솔루션|롯데정보통신|릭스솔루션|비트컴퓨터|삼성에스디에스|신세계 I&C|쌍용정보통신|아시아나IDT|아이크래프트|아이티센|에스트래픽|오상자이엘|오파스넷|위즈코프|정원엔시스|케이씨에스|케이엘넷|포스코 ICT|한솔인티큐브|한화시스템|현대무벡스|현대오토에버|